20 15 9 14
1 1 1 1 1 1 1 1 1 1 1 1 1 1 1 1 1 1 1 1
1 T T F 0 T F 0 0 T 0 0 0 0 1 T T T T 1
1 T T F 0 0 F 0 0 0 0 1 1 0 1 0 F F 0 1
1 F F F 0 0 F 0 0 0 0 0 1 1 1 0 0 0 0 1
1 1 1 0 1 1 1 1 1 0 0 0 0 0 0 F F F 0 1
E 0 F 0 0 0 0 T 1 1 1 1 F 1 1 1 0 T 1 1
1 T 1 0 0 0 0 0 F 0 0 T T 1 0 1 0 0 1 0
1 F 1 0 1 1 1 1 0 1 1 1 1 1 0 1 F 0 1 0
0 0 1 0 0 0 0 0 0 1 0 0 0 0 0 1 0 F 1 0
0 1 1 0 0 0 0 0 0 1 0 0 0 0 0 1 0 0 1 0
0 1 T F 0 1 0 0 0 1 1 1 1 1 1 1 T 0 1 0
0 1 T F F 1 0 0 0 1 0 0 F T 0 0 0 0 1 0
0 1 1 1 0 1 1 0 0 1 0 0 F 0 0 0 0 T 1 0
0 0 0 0 0 T 1 1 0 T 0 1 1 1 1 1 1 1 1 0
1 1 1 1 1 1 1 1 0 0 0 1 0 0 0 0 0 0 0 0
Finally stupid human language. Hello dumb human!